################
#            ###
# ## ####### ###
# ## ####    ###
#B##      ##   #
###  #### ### ##
    ##### ### ##
 ####     ### ##
 #### ####### ##
              ##
A############ ##
